Aria | Composer | Opera | Voice | Filename
----------------------------------------------------------------------------------------------------
Era pura come in cielo | Donizetti, Gaetano | Adelia, ossia La figlia dell'arciere | Bass | Era pura come in cielo.pdf
Ah! Non è non è tal nome | Donizetti, Gaetano | Adelia, ossia La figlia dell'arciere | Soprano | Ah! Non è non è tal nome.pdf
Ecco a tuoi piedi io cado | Donizetti, Gaetano | Adelia, ossia La figlia dell'arciere | Soprano | Ecco a tuoi piedi io cado.pdf
Fui presaga ah tu lo vedi | Donizetti, Gaetano | Adelia, ossia La figlia dell'arciere | Soprano | Fui presaga ah tu lo vedi.pdf
M'ingannò la mia speranza | Donizetti, Gaetano | Adelia, ossia La figlia dell'arciere | Tenor | M'ingannò la mia speranza.pdf
Oh! Come dolce all'anima | Donizetti, Gaetano | Alina, regina di Golconda | Baritone | Oh! Come dolce all'anima.pdf
Io sognai che disperato | Donizetti, Gaetano | Alina, regina di Golconda | Bass | Io sognai che disperato.pdf
Che val ricchezza e trono | Donizetti, Gaetano | Alina, regina di Golconda | Mezzo-soprano | Che val ricchezza e trono.pdf
Se il valor vostro, o prodi | Donizetti, Gaetano | Alina, regina di Golconda | Mezzo-soprano | Se il valor vostro, o prodi.pdf
Dunque invan mi lusingai | Donizetti, Gaetano | Alina, regina di Golconda | Tenor | Dunque invan mi lusingai.pdf
Se valor, rispetto e fede | Donizetti, Gaetano | Alina, regina di Golconda | Tenor | Se valor, rispetto e fede.pdf
Ah! Parea che per incanto | Donizetti, Gaetano | Anna Bolena | Mezzo-soprano | Ah! Parea che per incanto.pdf
Deh! Non voler costringere | Donizetti, Gaetano | Anna Bolena | Mezzo-soprano | Deh! Non voler costringere.pdf
Per questa fiamma indomita | Donizetti, Gaetano | Anna Bolena | Mezzo-soprano | Per questa fiamma indomita.pdf
Al dolce guidami castel natio | Donizetti, Gaetano | Anna Bolena | Soprano | Al dolce guidami castel natio.pdf
Come innocente giovane…Non v'ha sguardo | Donizetti, Gaetano | Anna Bolena | Soprano | Come innocente giovane…Non v'ha sguardo.pdf
Da quel dì che lei perduta… Ah! Cosi nei di ridenti | Donizetti, Gaetano | Anna Bolena | Tenor | Da quel dì che lei perduta… Ah! Cosi nei di ridenti.pdf
Vivi tu, te ne scongiuro… Nel veder la tua costanza | Donizetti, Gaetano | Anna Bolena | Tenor | Vivi tu, te ne scongiuro… Nel veder la tua costanza.pdf
Da quel di che l'innocente | Donizetti, Gaetano | Belisario | Soprano | Da quel di che l'innocente.pdf
Sin la tomba è a me negata! | Donizetti, Gaetano | Belisario | Soprano | Sin la tomba è a me negata!.pdf
Corri, amica | Donizetti, Gaetano | Belisario | Soprano | Corri, amica.pdf
A si tremendo annunzio | Donizetti, Gaetano | Belisario | Tenor | A si tremendo annunzio.pdf
I destini del soldato | Donizetti, Gaetano | Betly, ossia La capanna svizzera | Baritone | I destini del soldato.pdf
Ti vedo, ti bacio, terreno natio | Donizetti, Gaetano | Betly, ossia La capanna svizzera | Baritone | Ti vedo, ti bacio, terreno natio.pdf
In questo semplice, modesto asilo | Donizetti, Gaetano | Betly, ossia La capanna svizzera | Soprano | In questo semplice, modesto asilo.pdf
Se crudele il cor mostrai | Donizetti, Gaetano | Betly, ossia La capanna svizzera | Soprano | Se crudele il cor mostrai.pdf
E fia ver? | Donizetti, Gaetano | Betly, ossia La capanna svizzera | Tenor | E fia ver.pdf
Da che a sposa Caterina | Donizetti, Gaetano | Caterina Cornaro | Baritone | Da che a sposa Caterina.pdf
Non turbarti a questi accenti | Donizetti, Gaetano | Caterina Cornaro | Baritone | Non turbarti a questi accenti.pdf
Credi che dorma, o incanto | Donizetti, Gaetano | Caterina Cornaro | Baritone | Credi che dorma, o incanto.pdf
Dell' empia Cipro il popolo | Donizetti, Gaetano | Caterina Cornaro | Baritone | Dell' empia Cipro il popolo.pdf
Pietà, Signore, ti muovano | Donizetti, Gaetano | Caterina Cornaro | Soprano | Pietà, Signore, ti muovano.pdf
Vieni o tu, che ognor io chiamo | Donizetti, Gaetano | Caterina Cornaro | Soprano | Vieni o tu, che ognor io chiamo.pdf
Io trar non voglio campi e onori… Morte, morte, fur troppi gl'insulti | Donizetti, Gaetano | Caterina Cornaro | Tenor | Io trar non voglio campi e onori… Morte, morte, fur troppi gl'insulti.pdf
Soldat j'ai rêvé la victoire | Donizetti, Gaetano | Dom Sébastien, roi de Portugal | Check (Camoens) | Soldat j'ai rêvé la victoire.pdf
O mon Dieu sur la terre | Donizetti, Gaetano | Dom Sébastien, roi de Portugal | Check (Zaida) | O mon Dieu sur la terre.pdf
Sol adoré de la patrie | Donizetti, Gaetano | Dom Sébastien, roi de Portugal | Check (Zaida) | Sol adoré de la patrie.pdf
Terra adorata de' padri miei | Donizetti, Gaetano | Dom Sébastien, roi de Portugal | Check (Zaida) | Terra adorata de' padri miei.pdf
Seul sur la terre | Donizetti, Gaetano | Dom Sébastien, roi de Portugal | Check (Dom Sebastien) | Seul sur la terre.pdf
Bella siccome un angelo | Donizetti, Gaetano | Don Pasquale | Check (Doctor Malatesta) | Bella siccome un angelo.pdf
Ah, un foco insolita | Donizetti, Gaetano | Don Pasquale | Bass | Ah, un foco insolita.pdf
La morale in tutto questo | Donizetti, Gaetano | Don Pasquale | Check (Norina) | La morale in tutto questo.pdf
Quel guardo, il cavaliere...So anch'io la virtù magica | Donizetti, Gaetano | Don Pasquale | Check (Norina) | Quel guardo, il cavaliere...So anch'io la virtù magica.pdf
Cercherò lontana terra | Donizetti, Gaetano | Don Pasquale | Check (Ernesto) | Cercherò lontana terra.pdf
Com'è gentil | Donizetti, Gaetano | Don Pasquale | Check (Ernesto) | Com'è gentil.pdf
Allons donc | Donizetti, Gaetano | Elisabeth | Bass | Allons donc.pdf
Je suis courrier | Donizetti, Gaetano | Elisabeth | Bass | Je suis courrier.pdf
Oui je devais | Donizetti, Gaetano | Elisabeth | Tenor | Oui je devais.pdf
Pardon pardon mon père | Donizetti, Gaetano | Elisabeth | Soprano | Pardon pardon mon père.pdf
Assez de soupirs! | Donizetti, Gaetano | Elisabeth | Mezzo-soprano | Assez de soupirs!.pdf
Faut-il donc que je desespere | Donizetti, Gaetano | Elisabeth | Tenor | Faut-il donc que je desespere.pdf
Faut-il, helas! | Donizetti, Gaetano | Elisabeth | Tenor | Faut-il, helas!.pdf
Que ton âme se rassure | Donizetti, Gaetano | Elisabeth | Tenor | Que ton âme se rassure.pdf
Se di regnar desio | Donizetti, Gaetano | Fausta | Tenor | Se di regnar desio.pdf
Manca alcuno | Donizetti, Gaetano | Fausta | Baritone | Manca alcuno.pdf
Dea che siedi in terzo cielo | Donizetti, Gaetano | Fausta | Soprano | Dea che siedi in terzo cielo.pdf
Par che mi dica ancora | Donizetti, Gaetano | Fausta | Soprano | Par che mi dica ancora.pdf
Tu che voli, già spirto beato | Donizetti, Gaetano | Fausta | Soprano | Tu che voli, già spirto beato.pdf
Ah perchè dirmi crudel | Donizetti, Gaetano | Fausta | Tenor | Ah perchè dirmi crudel.pdf
Ah! nel cor mi suona un grido | Donizetti, Gaetano | Gemma di Vergy | Baritone | Ah! nel cor mi suona un grido.pdf
Ecco il pegno ch'io le porsi | Donizetti, Gaetano | Gemma di Vergy | Baritone | Ecco il pegno ch'io le porsi.pdf
Nella stanza, che romita | Donizetti, Gaetano | Gemma di Vergy | Bass | Nella stanza, che romita.pdf
Un fatal presentimento | Donizetti, Gaetano | Gemma di Vergy | Bass | Un fatal presentimento.pdf
Un'altare, ed una benda | Donizetti, Gaetano | Gemma di Vergy | Soprano | Un'altare, ed una benda.pdf
Una voce al cor d'intorno | Donizetti, Gaetano | Gemma di Vergy | Soprano | Una voce al cor d'intorno.pdf
Perche Gemma | Donizetti, Gaetano | Gemma di Vergy | Tenor | Perche Gemma.pdf
Fasti? Pompe? Omaggi? Onori? | Donizetti, Gaetano | Gianni di Calais | Tenor | Fasti Pompe Omaggi Onori.pdf
Di tua belta de immagine | Donizetti, Gaetano | I martiri | Baritone | Di tua belta de immagine.pdf
Di quai soa vi lagrime | Donizetti, Gaetano | I martiri | Soprano | Di quai soa vi lagrime.pdf
All' udir che il mio tesor | Donizetti, Gaetano | I pazzi per progetto | Check (Norina) | All' udir che il mio tesor.pdf
Piacer si nuovo e grato | Donizetti, Gaetano | I pazzi per progetto | Check (Norina) | Piacer si nuovo e grato.pdf
Va, e la nave in un baleno | Donizetti, Gaetano | Il borgomastro di Saardam | Baritone | Va, e la nave in un baleno.pdf
Fate largo al Borgomastro | Donizetti, Gaetano | Il borgomastro di Saardam | Bass | Fate largo al Borgomastro.pdf
Lungi da te mio ben | Donizetti, Gaetano | Il borgomastro di Saardam | Soprano | Lungi da te mio ben.pdf
Quanto grata è a voi | Donizetti, Gaetano | Il borgomastro di Saardam | Soprano | Quanto grata è a voi.pdf
Mesci, mesci e sperda il vento | Donizetti, Gaetano | Il campanello di notte | Baritone | Mesci, mesci e sperda il vento.pdf
Bella cosa, amici cara | Donizetti, Gaetano | Il campanello di notte | Bass | Bella cosa, amici cara.pdf
Lo stringi, e giunta appena | Donizetti, Gaetano | Il castello di Kenilworth | Baritone | Lo stringi, e giunta appena.pdf
Par che mi dica ancora | Donizetti, Gaetano | Il castello di Kenilworth | Soprano | Par che mi dica ancora.pdf
Tu potesti un sol istante | Donizetti, Gaetano | Il castello di Kenilworth | Check (Elisabetta) | Tu potesti un sol istante.pdf
Dio tremendo onnipossente | Donizetti, Gaetano | Il diluvio universale | Check (Noè) | Dio tremendo onnipossente.pdf
In quell' arca rispettate | Donizetti, Gaetano | Il diluvio universale | Check (Noè) | In quell' arca rispettate.pdf
Non mi tra dir, speranza | Donizetti, Gaetano | Il diluvio universale | Mezzo-soprano | Non mi tra dir, speranza.pdf
Perchè nell' alma inquesto loco | Donizetti, Gaetano | Il diluvio universale | Soprano | Perchè nell' alma inquesto loco.pdf
Senza colpa mi se acciaste | Donizetti, Gaetano | Il diluvio universale | Soprano | Senza colpa mi se acciaste.pdf
Addio conquistata mia terra | Donizetti, Gaetano | Il duca d'Alba | Baritone | Addio conquistata mia terra.pdf
Nei miei superbi gaudi | Donizetti, Gaetano | Il duca d'Alba | Baritone | Nei miei superbi gaudi.pdf
In seno ai mar | Donizetti, Gaetano | Il duca d'Alba | Soprano | In seno ai mar.pdf
Ombra paterna | Donizetti, Gaetano | Il duca d'Alba | Soprano | Ombra paterna.pdf
Angelo casto e bel | Donizetti, Gaetano | Il duca d'Alba | Tenor | Angelo casto e bel.pdf
Se pietoso d'un obblio copri | Donizetti, Gaetano | Il furioso nell'isola di San Domingo | Soprano | Se pietoso d'un obblio copri.pdf
Vedea languir quel misero | Donizetti, Gaetano | Il furioso nell'isola di San Domingo | Soprano | Vedea languir quel misero.pdf
Dalle piume in cui giacea | Donizetti, Gaetano | Il furioso nell'isola di San Domingo | Tenor | Dalle piume in cui giacea.pdf
Se ai voti di quest'alma... Affrettati vola momento beato | Donizetti, Gaetano | Il furioso nell'isola di San Domingo | Tenor | Se ai voti di quest'alma... Affrettati vola momento beato.pdf
Taci il voglio | Donizetti, Gaetano | Il giovedì grasso, ossia Il nuovo Pourceaugnac | Baritone | Taci il voglio.pdf
Mo che si scopierto a vamma | Donizetti, Gaetano | Il giovedì grasso, ossia Il nuovo Pourceaugnac | Bass | Mo che si scopierto a vamma.pdf
Or che l'annoda Imene | Donizetti, Gaetano | Il giovedì grasso, ossia Il nuovo Pourceaugnac | Soprano | Or che l'annoda Imene.pdf
Servi gente | Donizetti, Gaetano | Il giovedì grasso, ossia Il nuovo Pourceaugnac | Tenor | Servi gente.pdf
Qui pel figlio una madre gridava | Donizetti, Gaetano | Il paria | Baritone | Qui pel figlio una madre gridava.pdf
Il figlio è qui | Donizetti, Gaetano | Il paria | Check (Zarette) | Il figlio è qui.pdf
Pare a che mentre l'aloe | Donizetti, Gaetano | Il paria | Soprano | Pare a che mentre l'aloe.pdf
Là dove il ciel s'estelle | Donizetti, Gaetano | Il paria | Tenor | Là dove il ciel s'estelle.pdf
Sugli occhi tuoi, spietata | Donizetti, Gaetano | L'ajo nell'imbarazzo | Baritone | Sugli occhi tuoi, spietata.pdf
Figlia son d'un colonnello | Donizetti, Gaetano | L'ajo nell'imbarazzo | Soprano | Figlia son d'un colonnello.pdf
Quel tuo sorriso, o padre | Donizetti, Gaetano | L'ajo nell'imbarazzo | Soprano | Quel tuo sorriso, o padre.pdf
Nel primo fior degl'anni | Donizetti, Gaetano | L'ajo nell'imbarazzo | Baritone | Nel primo fior degl'anni.pdf
Ogni inciampo è alfin distrutto | Donizetti, Gaetano | L'assedio di Calais | Baritone | Ogni inciampo è alfin distrutto.pdf
Al mio cor oggetti amati | Donizetti, Gaetano | L'assedio di Calais | Mezzo-soprano | Al mio cor oggetti amati.pdf
Come Paride vezzoso | Donizetti, Gaetano | L'elisir d'amore | Check (Belcore) | Come Paride vezzoso.pdf
Udite, udite, o rustici | Donizetti, Gaetano | L'elisir d'amore | Check (Doctor Dulcamara) | Udite, udite, o rustici.pdf
Della crudele Isotta | Donizetti, Gaetano | L'elisir d'amore | Check (Adina) | Della crudele Isotta.pdf
Prendi, per me sei libero | Donizetti, Gaetano | L'elisir d'amore | Check (Adina) | Prendi, per me sei libero.pdf
Quanto è bella, quanto è cara | Donizetti, Gaetano | L'elisir d'amore | Check (Nemorino) | Quanto è bella, quanto è cara.pdf
Una furtiva lagrima | Donizetti, Gaetano | L'elisir d'amore | Check (Nemorino) | Una furtiva lagrima.pdf
In dura schiavitei | Donizetti, Gaetano | L'eremitaggio di Liverpool | Baritone | In dura schiavitei.pdf
Madre deh placati | Donizetti, Gaetano | L'eremitaggio di Liverpool | Soprano | Madre deh placati.pdf
Eccomi a voi | Donizetti, Gaetano | L'esule di Roma, ossia Il proscritto | Bass | Eccomi a voi.pdf
Entra nel circo | Donizetti, Gaetano | L'esule di Roma, ossia Il proscritto | Bass | Entra nel circo.pdf
Tardi tardi il pie la volgi | Donizetti, Gaetano | L'esule di Roma, ossia Il proscritto | Soprano | Tardi tardi il pie la volgi.pdf
Aure di Roma!... Tacqui allor, l'abbandonai… Se ad altri il core | Donizetti, Gaetano | L'esule di Roma, ossia Il proscritto | Tenor | Aure di Roma!... Tacqui allor, l'abbandonai… Se ad altri il core.pdf
S'io finor, bell'idol mio | Donizetti, Gaetano | L'esule di Roma, ossia Il proscritto | Tenor | S'io finor, bell'idol mio.pdf
A tanto amor | Donizetti, Gaetano | La favorite (La favorita) | Bass | A tanto amor.pdf
O mon Fernand (O mio Fernando) | Donizetti, Gaetano | La favorite (La favorita) | Check (Léonore de Guzman (Leonora di Gusman)) | O mon Fernand (O mio Fernando).pdf
Rayons dorés (Dolce zeffiro, il seconda) | Donizetti, Gaetano | La favorite (La favorita) | Check (Inès (Inez)) | Rayons dorés (Dolce zeffiro, il seconda).pdf
Ange si pur (Spirto gentil) | Donizetti, Gaetano | La favorite (La favorita) | Tenor | Ange si pur (Spirto gentil).pdf
Oui, ta voix m'inspire (Si, che un tuo solo accento) | Donizetti, Gaetano | La favorite (La favorita) | Tenor | Oui, ta voix m'inspire (Si, che un tuo solo accento).pdf
Un ange, une femme inconnue (Una vergine, un angel di Dio) | Donizetti, Gaetano | La favorite (La favorita) | Tenor | Un ange, une femme inconnue (Una vergine, un angel di Dio).pdf
Chacun le sait | Donizetti, Gaetano | La fille du régiment | Check (Marie) | Chacun le sait.pdf
Il faut partir mes bons compagnons d'armes | Donizetti, Gaetano | La fille du régiment | Check (Marie) | Il faut partir mes bons compagnons d'armes.pdf
Par le rang et par l'opulence | Donizetti, Gaetano | La fille du régiment | Check (Marie) | Par le rang et par l'opulence.pdf
Salut a la France | Donizetti, Gaetano | La fille du régiment | Check (Marie) | Salut a la France.pdf
Ah! mes amis, quel jour de fête!...Pour mon âme | Donizetti, Gaetano | La fille du régiment | Check (Tonio) | Ah! mes amis, quel jour de fête!...Pour mon âme.pdf
Pour me rapprocher de Marie | Donizetti, Gaetano | La fille du régiment | Check (Tonio) | Pour me rapprocher de Marie.pdf
Maitre de danse par excellence | Donizetti, Gaetano | La lettera anonima | Bass | Maitre de danse par excellence.pdf
Ricevi in questo amplesso | Donizetti, Gaetano | La lettera anonima | Check (Rosina) | Ricevi in questo amplesso.pdf
No, non è vero | Donizetti, Gaetano | La lettera anonima | Tenor | No, non è vero.pdf
Non v'è maggior dolore | Donizetti, Gaetano | La romanziera e l'uomo nero | Tenor | Non v'è maggior dolore.pdf
Si colpevole son io | Donizetti, Gaetano | La romanziera e l'uomo nero | Soprano | Si colpevole son io.pdf
Tu di rose inghirlandate | Donizetti, Gaetano | La romanziera e l'uomo nero | Soprano | Tu di rose inghirlandate.pdf
Ecco il pugnal sù | Donizetti, Gaetano | La zingara | Baritone | Ecco il pugnal sù.pdf
Perchè non basto afrangervi | Donizetti, Gaetano | La zingara | Bass | Perchè non basto afrangervi.pdf
Donzelle a penetrar | Donizetti, Gaetano | La zingara | Mezzo-soprano | Donzelle a penetrar.pdf
E fia ver di si grandono | Donizetti, Gaetano | La zingara | Mezzo-soprano | E fia ver di si grandono.pdf
A te nell'appressarmi | Donizetti, Gaetano | La zingara | Tenor | A te nell'appressarmi.pdf
Assisa a pie d'un salice | Donizetti, Gaetano | Le convenienze ed inconvenienze teatrali | Baritone | Assisa a pie d'un salice.pdf
Lazaroni sfacendati | Donizetti, Gaetano | Le convenienze ed inconvenienze teatrali | Baritone | Lazaroni sfacendati.pdf
Che credete che mia figlia | Donizetti, Gaetano | Le convenienze ed inconvenienze teatrali | Baritone | Che credete che mia figlia.pdf
E puoi goder tiranno! | Donizetti, Gaetano | Le convenienze ed inconvenienze teatrali | Soprano | E puoi goder tiranno!.pdf
Ambo nati in questa valle | Donizetti, Gaetano | Linda di Chamounix | Baritone | Ambo nati in questa valle.pdf
Buona gente | Donizetti, Gaetano | Linda di Chamounix | Check (Marchese) | Buona gente.pdf
Ella è un giglio di puro candore | Donizetti, Gaetano | Linda di Chamounix | Check (Marchese) | Ella è un giglio di puro candore.pdf
Cari luoghi ov'io passai | Donizetti, Gaetano | Linda di Chamounix | Mezzo-soprano | Cari luoghi ov'io passai.pdf
O luce di quest'anima | Donizetti, Gaetano | Linda di Chamounix | Soprano | O luce di quest'anima.pdf
È la voce che primiera | Donizetti, Gaetano | Linda di Chamounix | Tenor | È la voce che primiera.pdf
Se tanto inica agli uomini | Donizetti, Gaetano | Linda di Chamounix | Tenor | Se tanto inica agli uomini.pdf
Cruda, funesta smania | Donizetti, Gaetano | Lucia di Lammermoor | Baritone | Cruda, funesta smania.pdf
La pietade in suo favore | Donizetti, Gaetano | Lucia di Lammermoor | Baritone | La pietade in suo favore.pdf
Ah, cedi, cedi! | Donizetti, Gaetano | Lucia di Lammermoor | Check (Raimondo Bidebent) | Ah, cedi, cedi!.pdf
Dalle stanze, ove Lucia | Donizetti, Gaetano | Lucia di Lammermoor | Check (Raimondo Bidebent) | Dalle stanze, ove Lucia.pdf
Il dolce suono mi colpì di sua voce | Donizetti, Gaetano | Lucia di Lammermoor | Check (Lucia di Lammermoor) | Il dolce suono mi colpì di sua voce.pdf
Quando rapito in estasi | Donizetti, Gaetano | Lucia di Lammermoor | Check (Lucia di Lammermoor) | Quando rapito in estasi.pdf
Regnava nel silenzio | Donizetti, Gaetano | Lucia di Lammermoor | Check (Lucia di Lammermoor) | Regnava nel silenzio.pdf
Spargi d'amaro pianto | Donizetti, Gaetano | Lucia di Lammermoor | Check (Lucia di Lammermoor) | Spargi d'amaro pianto.pdf
Tombe degl'avi miei | Donizetti, Gaetano | Lucia di Lammermoor | Check (Edgardo) | Tombe degl'avi miei.pdf
Tu che a Dio spiegasti l'ali | Donizetti, Gaetano | Lucia di Lammermoor | Check (Edgardo) | Tu che a Dio spiegasti l'ali.pdf
Vieni! la mia vendetta | Donizetti, Gaetano | Lucrezia Borgia | Baritone | Vieni! la mia vendetta.pdf
Il segreto per esser felici | Donizetti, Gaetano | Lucrezia Borgia | Check (Maffio Orsini) | Il segreto per esser felici.pdf
Nella fatal di Rimini | Donizetti, Gaetano | Lucrezia Borgia | Check (Maffio Orsini) | Nella fatal di Rimini.pdf
Com'è bello | Donizetti, Gaetano | Lucrezia Borgia | Check (Lucrezia Borgia) | Com'è bello.pdf
Era desso il figlio mio | Donizetti, Gaetano | Lucrezia Borgia | Check (Lucrezia Borgia) | Era desso il figlio mio.pdf
M'odi, ah m'odi | Donizetti, Gaetano | Lucrezia Borgia | Check (Lucrezia Borgia) | M'odi, ah m'odi.pdf
Di pescatore ignobile | Donizetti, Gaetano | Lucrezia Borgia | Check (Gennaro) | Di pescatore ignobile.pdf
Ah! non avea piu lagrime | Donizetti, Gaetano | Maria de Rudenz | Baritone | Ah! non avea piu lagrime.pdf
Mostro iniquo tremar tu dovevi | Donizetti, Gaetano | Maria de Rudenz | Soprano | Mostro iniquo tremar tu dovevi.pdf
Si, del chiostro penitente | Donizetti, Gaetano | Maria de Rudenz | Soprano | Si, del chiostro penitente.pdf
Talor nel mio delirio | Donizetti, Gaetano | Maria de Rudenz | Baritone | Talor nel mio delirio.pdf
Bella e di sol vestita | Donizetti, Gaetano | Maria di Rohan | Baritone | Bella e di sol vestita.pdf
Gemea di tetro carcere... Se ancor m'è dato stringerti | Donizetti, Gaetano | Maria di Rohan | Baritone | Gemea di tetro carcere... Se ancor m'è dato stringerti.pdf
Per non istare in ozio | Donizetti, Gaetano | Maria di Rohan | Mezzo-soprano | Per non istare in ozio.pdf
Son leggero, è ver, d'amore | Donizetti, Gaetano | Maria di Rohan | Mezzo-soprano | Son leggero, è ver, d'amore.pdf
Benigno il cielo arridere | Donizetti, Gaetano | Maria di Rohan | Soprano | Benigno il cielo arridere.pdf
Cupa fatal mestizia... Ben fu il giorno avventurato | Donizetti, Gaetano | Maria di Rohan | Soprano | Cupa fatal mestizia... Ben fu il giorno avventurato.pdf
Preghiera: Havvi un Dio che in sua clemenza | Donizetti, Gaetano | Maria di Rohan | Soprano | Preghiera Havvi un Dio che in sua clemenza.pdf
Alma soave e cara | Donizetti, Gaetano | Maria di Rohan | Check (Riccardo) | Alma soave e cara.pdf
Quando il cor da lei piagato... A te, divina immagine | Donizetti, Gaetano | Maria di Rohan | Check (Riccardo) | Quando il cor da lei piagato... A te, divina immagine.pdf
Ah! ce fut pour mon coeur | Donizetti, Gaetano | Maria Padilla | Baritone | Ah! ce fut pour mon coeur.pdf
Nos deux ames étaient faites | Donizetti, Gaetano | Maria Padilla | Soprano | Nos deux ames étaient faites.pdf
Je marchais pieux dans la vie | Donizetti, Gaetano | Maria Padilla | Tenor | Je marchais pieux dans la vie.pdf
Ah! quando all'ara sorgemi…Ah dal ciel discenda un raggio | Donizetti, Gaetano | Maria Stuarda | Check (Elisabetta) | Ah! quando all'ara sorgemi…Ah dal ciel discenda un raggio.pdf
Quella vita a me funesta | Donizetti, Gaetano | Maria Stuarda | Check (Elisabetta) | Quella vita a me funesta.pdf
Ah! se un giorno da queste ritorte | Donizetti, Gaetano | Maria Stuarda | Soprano | Ah! se un giorno da queste ritorte.pdf
Di un cor che more | Donizetti, Gaetano | Maria Stuarda | Soprano | Di un cor che more.pdf
Oh nube! che lieve per l'aria ti aggiri...Nella pace del mesto riposo | Donizetti, Gaetano | Maria Stuarda | Soprano | Oh nube! che lieve per l'aria ti aggiri...Nella pace del mesto riposo.pdf
Ah! rimiro il bel sembiante | Donizetti, Gaetano | Maria Stuarda | Check (Leicester) | Ah! rimiro il bel sembiante.pdf
Era anch'io di quella schiero | Donizetti, Gaetano | Marino Faliero | Baritone | Era anch'io di quella schiero.pdf
Odo il suon di chi sprezza i perigli | Donizetti, Gaetano | Marino Faliero | Baritone | Odo il suon di chi sprezza i perigli.pdf
Bello ardir di congiurati... Fosca notte, notte orrenda | Donizetti, Gaetano | Marino Faliero | Bass | Bello ardir di congiurati... Fosca notte, notte orrenda.pdf
Tutto or morte, oh Dio!... Fra due tombe fra due spettri | Donizetti, Gaetano | Marino Faliero | Soprano | Tutto or morte, oh Dio!... Fra due tombe fra due spettri.pdf
Di mia patria o' bel soggiorno... Un solo conforto | Donizetti, Gaetano | Marino Faliero | Tenor | Di mia patria o' bel soggiorno... Un solo conforto.pdf
Io ti veggio, or vegli e tremi... Questa è l'ora | Donizetti, Gaetano | Marino Faliero | Tenor | Io ti veggio, or vegli e tremi... Questa è l'ora.pdf
Bene, bravi | Donizetti, Gaetano | Olivo e Pasquale | Bass | Bene, bravi.pdf
Come vuoi ch'io freni il pianto | Donizetti, Gaetano | Olivo e Pasquale | Soprano | Come vuoi ch'io freni il pianto.pdf
Se palpitai d'affanno | Donizetti, Gaetano | Olivo e Pasquale | Soprano | Se palpitai d'affanno.pdf
Grazie clementi Dei! | Donizetti, Gaetano | Olivo e Pasquale | Tenor | Grazie clementi Dei!.pdf
Per veder sù quel bel viso | Donizetti, Gaetano | Parisina | Baritone | Per veder sù quel bel viso.pdf
Ciel sei tu che in tal momento | Donizetti, Gaetano | Parisina | Soprano | Ciel sei tu che in tal momento.pdf
Forse un destin, che intendere | Donizetti, Gaetano | Parisina | Soprano | Forse un destin, che intendere.pdf
Sogno talor di correre | Donizetti, Gaetano | Parisina | Soprano | Sogno talor di correre.pdf
Io sentù tremar la mano | Donizetti, Gaetano | Parisina | Tenor | Io sentù tremar la mano.pdf
Alimento alla fiamma si porga | Donizetti, Gaetano | Poliuto | Bass | Alimento alla fiamma si porga.pdf
Di tua beltade immagine... No, l'acciar non fu spietato | Donizetti, Gaetano | Poliuto | Baritone | Di tua beltade immagine... No, l'acciar non fu spietato.pdf
Di quai soavi lagrime... Perchè di stolto giubilo | Donizetti, Gaetano | Poliuto | Soprano | Di quai soavi lagrime... Perchè di stolto giubilo.pdf
D'un alma troppo fervida | Donizetti, Gaetano | Poliuto | Tenor | D'un alma troppo fervida.pdf
Fu macchiato l'onor mio! | Donizetti, Gaetano | Poliuto | Tenor | Fu macchiato l'onor mio!.pdf
Forse in quel cor sensibile | Donizetti, Gaetano | Roberto Devereux, ossia Il conte di Essex | Check (The Duke of Nottingham) | Forse in quel cor sensibile.pdf
All'afflitto è dolce il pianto | Donizetti, Gaetano | Roberto Devereux, ossia Il conte di Essex | Check (Sara, Duchess of Nottingham) | All'afflitto è dolce il pianto.pdf
L'amor suo mi fe beata | Donizetti, Gaetano | Roberto Devereux, ossia Il conte di Essex | Check (Elisabetta, Queen of England) | L'amor suo mi fe beata.pdf
Vivi ingrato, a lei d'accanto | Donizetti, Gaetano | Roberto Devereux, ossia Il conte di Essex | Check (Elisabetta, Queen of England) | Vivi ingrato, a lei d'accanto.pdf
A te dirò negli ultimi singhiozzi | Donizetti, Gaetano | Roberto Devereux, ossia Il conte di Essex | Check (Roberto Devereux, Earl of Essex) | A te dirò negli ultimi singhiozzi.pdf
Ah! Non tremava | Donizetti, Gaetano | Sancia di Castiglia | Bass | Ah! Non tremava.pdf
Troppo omai nel cor mi preme | Donizetti, Gaetano | Sancia di Castiglia | Mezzo-soprano | Troppo omai nel cor mi preme.pdf
Al figlio tuo la morte | Donizetti, Gaetano | Sancia di Castiglia | Soprano | Al figlio tuo la morte.pdf
Io talor piu nol rammento | Donizetti, Gaetano | Sancia di Castiglia | Soprano | Io talor piu nol rammento.pdf
Perchè dell' aure in sen | Donizetti, Gaetano | Torquato Tasso | Baritone | Perchè dell' aure in sen.pdf
Io posposto ad un Torquato | Donizetti, Gaetano | Torquato Tasso | Bass | Io posposto ad un Torquato.pdf
Io l' udía ne' suoi bei carmi | Donizetti, Gaetano | Torquato Tasso | Soprano | Io l' udía ne' suoi bei carmi.pdf
Quel tuo sorriso altero | Donizetti, Gaetano | Torquato Tasso | Check (Roberto Geraldini) | Quel tuo sorriso altero.pdf
Prova mi dai, lo sento | Donizetti, Gaetano | Ugo, conte di Parigi | Mezzo-soprano | Prova mi dai, lo sento.pdf
Ah! quando in regio ta lamo | Donizetti, Gaetano | Ugo, conte di Parigi | Soprano | Ah! quando in regio ta lamo.pdf
Di che amore io t'abbia amato | Donizetti, Gaetano | Ugo, conte di Parigi | Soprano | Di che amore io t'abbia amato.pdf
